2007-05-13 19:58:31,eHour-wicketweb/src/main/webapp/css/ehourAdmin.jsp,128,0,2,126,0
2007-05-13 19:58:31,eHour-wicketweb/src/main/webapp/css/ehourLogin.jsp,126,0,2,124,0
2007-05-13 19:58:31,eHour-wicketweb/src/main/webapp/css/ehourReport.jsp,199,0,2,197,0
2007-05-13 19:58:31,eHour-wicketweb/src/main/webapp/css/ehourTimesheet.jsp,527,0,2,525,0
2007-05-13 19:58:31,eHour-wicketweb/src/main/webapp/css/ehourUserReport.jsp,75,0,2,73,0
2007-05-07 11:32:03,eHour-web/src/main/webapp/accessDenied.jsp,41,0,3,38,0
2007-05-07 11:28:41,eHour-web/src/main/webapp/WEB-INF/jsp/pmReport/projectReport.jsp,121,0,4,117,0
2007-05-07 11:28:41,eHour-web/src/main/webapp/WEB-INF/jsp/pmReport/reportCriteria.jsp,127,0,5,122,0
2007-05-07 11:28:41,eHour-web/src/main/webapp/WEB-INF/jsp/report/criteria/criteria.jsp,334,0,5,329,0
2007-05-07 11:28:41,eHour-web/src/main/webapp/WEB-INF/jsp/report/report/reportPerCustomer.jsp,166,0,4,162,0
2007-05-07 11:28:41,eHour-web/src/main/webapp/WEB-INF/jsp/report/report/reportPerProject.jsp,153,0,4,149,0
2007-05-07 11:28:41,eHour-web/src/main/webapp/WEB-INF/jsp/report/report/reportPerUser.jsp,152,0,4,148,0
2007-05-07 11:28:41,eHour-web/src/main/webapp/WEB-INF/jsp/timesheet/overview.jsp,183,0,5,178,0
2007-05-07 11:28:41,eHour-web/src/main/webapp/WEB-INF/jsp/timesheet/printForm.jsp,111,0,4,107,0
2007-05-07 11:28:41,eHour-web/src/main/webapp/WEB-INF/jsp/timesheet/printSheet.jsp,132,0,4,128,0
2007-05-07 11:28:41,eHour-web/src/main/webapp/WEB-INF/jsp/timesheet/timesheet.jsp,193,0,3,190,0
2007-05-07 11:28:41,eHour-web/src/main/webapp/WEB-INF/jsp/userReport/criteria.jsp,121,0,5,116,0
2007-05-07 11:28:41,eHour-web/src/main/webapp/WEB-INF/jsp/userReport/projectReport.jsp,159,0,5,154,0
2007-05-07 11:28:41,eHour-web/src/main/webapp/css/ehourReport.jsp,199,0,2,197,0
2007-05-07 10:39:46,eHour-web/src/main/webapp/WEB-INF/jsp/timesheet/overviewLayout.jsp,38,0,4,34,0
2007-05-07 10:39:46,eHour-web/src/main/webapp/WEB-INF/jsp/timesheet/timesheet.jsp,191,0,3,188,0
2007-05-07 10:39:46,eHour-web/src/main/webapp/css/ehourTimesheet.jsp,527,0,2,525,0
2007-05-07 07:47:39,eHour-web/src/main/webapp/logon.jsp,106,0,6,100,0
2007-05-07 07:06:18,eHour-web/src/main/webapp/index.jsp,15,0,1,14,0
2007-05-07 07:06:18,eHour-web/src/main/webapp/login.jsp,15,0,1,14,0
2007-05-07 07:01:44,eHour-web/src/main/webapp/WEB-INF/jsp/admin/config/localeConfiguration.jsp,137,0,4,133,0
2007-05-07 07:01:44,eHour-web/src/main/webapp/css/ehourLogin.jsp,126,0,2,124,0
2007-05-07 07:01:44,eHour-web/src/main/webapp/logon.jsp,106,0,6,100,0
2007-05-05 07:25:12,eHour-web/src/main/webapp/login.jsp,75,0,6,69,0
2007-05-05 06:43:40,eHour-web/src/main/webapp/WEB-INF/jsp/report/criteria/criteria.jsp,334,0,5,329,0
2007-05-04 22:09:14,eHour-web/src/main/webapp/WEB-INF/jsp/report/criteria/criteria.jsp,322,0,5,317,0
2007-05-04 22:09:14,eHour-web/src/main/webapp/WEB-INF/jsp/report/criteria/quickDate.jsp,5,0,1,4,0
2007-05-04 19:25:38,eHour-web/src/main/webapp/WEB-INF/jsp/userReport/projectReport.jsp,159,0,5,154,0
2007-05-04 18:46:27,eHour-web/src/main/webapp/WEB-INF/jsp/userReport/projectReport.jsp,138,0,5,133,0
2007-05-04 18:38:06,eHour-web/src/main/webapp/WEB-INF/jsp/admin/assignment/assignmentForm.jsp,362,0,4,358,0
2007-05-04 18:38:06,eHour-web/src/main/webapp/WEB-INF/jsp/pmReport/reportCriteria.jsp,127,0,5,122,0
2007-05-04 18:38:06,eHour-web/src/main/webapp/WEB-INF/jsp/userReport/criteria.jsp,121,0,5,116,0
2007-05-03 19:30:44,eHour-web/src/main/webapp/WEB-INF/jsp/admin/assignment/assignmentForm.jsp,342,0,4,338,0
2007-05-03 17:56:13,eHour-web/src/main/webapp/WEB-INF/jsp/admin/assignment/assignmentForm.jsp,329,0,4,325,0
2007-05-02 18:38:36,eHour-web/src/main/webapp/WEB-INF/jsp/report/criteria/criteria.jsp,282,0,5,277,0
2007-05-02 17:59:57,eHour-web/src/main/webapp/WEB-INF/jsp/layout/layoutBase.jsp,83,0,5,78,0
2007-05-02 17:59:57,eHour-web/src/main/webapp/WEB-INF/jsp/report/criteria/criteria.jsp,283,0,5,278,0
2007-05-02 17:59:57,eHour-web/src/main/webapp/WEB-INF/jsp/report/printLayout.jsp,39,0,4,35,0
2007-05-02 17:59:57,eHour-web/src/main/webapp/WEB-INF/jsp/report/report/reportPerCustomer.jsp,166,0,4,162,0
2007-05-02 17:59:57,eHour-web/src/main/webapp/WEB-INF/jsp/report/report/reportPerProject.jsp,153,0,4,149,0
2007-05-02 17:59:57,eHour-web/src/main/webapp/WEB-INF/jsp/report/report/reportPerUser.jsp,152,0,4,148,0
2007-05-02 17:59:57,eHour-web/src/main/webapp/WEB-INF/jsp/report/reportLayout.jsp,31,0,4,27,0
2007-05-02 17:59:57,eHour-web/src/main/webapp/css/ehourReport.jsp,199,0,2,197,0
2007-05-02 16:09:54,eHour-web/src/main/webapp/WEB-INF/jsp/pmReport/projectReport.jsp,121,0,4,117,0
2007-05-01 19:23:23,eHour-web/src/main/webapp/WEB-INF/jsp/report/report/reportPerCustomer.jsp,156,0,4,152,0
2007-05-01 19:23:23,eHour-web/src/main/webapp/WEB-INF/jsp/report/report/reportPerProject.jsp,143,0,4,139,0
2007-05-01 19:23:23,eHour-web/src/main/webapp/WEB-INF/jsp/report/report/reportPerUser.jsp,142,0,4,138,0
2007-05-01 18:36:38,eHour-web/src/main/webapp/WEB-INF/jsp/pmReport/reportCriteria.jsp,101,0,5,96,0
2007-05-01 18:02:43,eHour-web/src/main/webapp/WEB-INF/jsp/report/report/reportPerProject.jsp,132,0,4,128,0
2007-05-01 18:02:43,eHour-web/src/main/webapp/WEB-INF/jsp/report/report/reportPerUser.jsp,131,0,4,127,0
2007-05-01 17:26:53,eHour-web/src/main/webapp/WEB-INF/jsp/timesheet/overview.jsp,183,0,5,178,0
2007-05-01 17:26:53,eHour-web/src/main/webapp/css/ehourTimesheet.jsp,483,0,2,481,0
2007-05-01 16:44:45,eHour-web/src/main/webapp/WEB-INF/jsp/report/report/reportPerCustomer.jsp,145,0,4,141,0
2007-05-01 16:44:45,eHour-web/src/main/webapp/WEB-INF/jsp/report/report/reportPerProject.jsp,130,0,4,126,0
2007-05-01 16:44:45,eHour-web/src/main/webapp/WEB-INF/jsp/report/report/reportPerUser.jsp,129,0,4,125,0
2007-04-30 19:45:17,eHour-web/src/main/webapp/WEB-INF/jsp/admin/assignment/assignmentForm.jsp,315,0,4,311,0
2007-04-30 19:45:17,eHour-web/src/main/webapp/WEB-INF/jsp/pmReport/projectReport.jsp,86,0,5,81,0
2007-04-30 19:45:17,eHour-web/src/main/webapp/WEB-INF/jsp/pmReport/reportCriteria.jsp,101,0,5,96,0
2007-04-30 19:45:17,eHour-web/src/main/webapp/WEB-INF/jsp/report/criteria/criteria.jsp,282,0,5,277,0
2007-04-30 19:45:17,eHour-web/src/main/webapp/WEB-INF/jsp/report/report/reportPerCustomer.jsp,134,0,4,130,0
2007-04-30 19:45:17,eHour-web/src/main/webapp/WEB-INF/jsp/report/report/reportPerUser.jsp,122,0,4,118,0
2007-04-30 19:45:17,eHour-web/src/main/webapp/WEB-INF/jsp/timesheet/overview.jsp,161,0,5,156,0
2007-04-30 19:45:17,eHour-web/src/main/webapp/WEB-INF/jsp/userReport/criteria.jsp,104,0,5,99,0
2007-04-29 08:50:49,eHour-web/src/main/webapp/accessDenied.jsp,41,0,3,38,0
2007-04-29 08:50:49,eHour-web/src/main/webapp/login.jsp,68,0,6,62,0
2007-04-26 18:00:40,eHour-web/src/main/webapp/WEB-INF/jsp/admin/assignment/assignmentForm.jsp,315,0,4,311,0
2007-04-26 18:00:40,eHour-web/src/main/webapp/WEB-INF/jsp/admin/assignment/index.jsp,93,0,5,88,0
2007-04-26 18:00:40,eHour-web/src/main/webapp/WEB-INF/jsp/admin/assignment/projectPmCheck.jsp,5,0,1,4,0
2007-04-26 18:00:40,eHour-web/src/main/webapp/WEB-INF/jsp/admin/config/index.jsp,70,0,5,65,0
2007-04-26 18:00:40,eHour-web/src/main/webapp/WEB-INF/jsp/admin/config/localeConfiguration.jsp,124,0,4,120,0
2007-04-26 18:00:40,eHour-web/src/main/webapp/WEB-INF/jsp/admin/customer/customerForm.jsp,109,0,4,105,0
2007-04-26 18:00:40,eHour-web/src/main/webapp/WEB-INF/jsp/admin/customer/index.jsp,72,0,5,67,0
2007-04-26 18:00:40,eHour-web/src/main/webapp/WEB-INF/jsp/admin/customer/listCustomers.jsp,15,0,3,12,0
2007-04-26 18:00:40,eHour-web/src/main/webapp/WEB-INF/jsp/admin/dept/index.jsp,70,0,5,65,0
2007-04-26 18:00:40,eHour-web/src/main/webapp/WEB-INF/jsp/admin/dept/listUserDepartments.jsp,19,0,3,16,0
2007-04-26 18:00:40,eHour-web/src/main/webapp/WEB-INF/jsp/admin/dept/userDepartmentForm.jsp,106,0,3,103,0
2007-04-26 18:00:40,eHour-web/src/main/webapp/WEB-INF/jsp/admin/index.jsp,1,0,0,1,0
2007-04-26 18:00:40,eHour-web/src/main/webapp/WEB-INF/jsp/admin/project/index.jsp,84,0,5,79,0
2007-04-26 18:00:40,eHour-web/src/main/webapp/WEB-INF/jsp/admin/project/listProjects.jsp,13,0,3,10,0
2007-04-26 18:00:40,eHour-web/src/main/webapp/WEB-INF/jsp/admin/project/projectForm.jsp,125,0,3,122,0
2007-04-26 18:00:40,eHour-web/src/main/webapp/WEB-INF/jsp/admin/user/index.jsp,100,0,5,95,0
2007-04-26 18:00:40,eHour-web/src/main/webapp/WEB-INF/jsp/admin/user/listUsers.jsp,13,0,3,10,0
2007-04-26 18:00:40,eHour-web/src/main/webapp/WEB-INF/jsp/admin/user/userForm.jsp,176,0,4,172,0
2007-04-26 18:00:40,eHour-web/src/main/webapp/WEB-INF/jsp/help/help.jsp,40,0,4,34,2
2007-04-26 18:00:40,eHour-web/src/main/webapp/WEB-INF/jsp/layout/layoutBase.jsp,83,0,5,78,0
2007-04-26 18:00:40,eHour-web/src/main/webapp/WEB-INF/jsp/nav/navAdmin.jsp,27,0,3,24,0
2007-04-26 18:00:40,eHour-web/src/main/webapp/WEB-INF/jsp/nav/navCalendar.jsp,30,0,4,26,0
2007-04-26 18:00:40,eHour-web/src/main/webapp/WEB-INF/jsp/nav/navHeader.jsp,49,0,4,45,0
2007-04-26 18:00:40,eHour-web/src/main/webapp/WEB-INF/jsp/nav/navReport.jsp,23,0,3,20,0
2007-04-26 18:00:40,eHour-web/src/main/webapp/WEB-INF/jsp/pmReport/noReport.jsp,1,0,0,1,0
2007-04-26 18:00:40,eHour-web/src/main/webapp/WEB-INF/jsp/pmReport/projectReport.jsp,86,0,5,81,0
2007-04-26 18:00:40,eHour-web/src/main/webapp/WEB-INF/jsp/pmReport/reportCriteria.jsp,101,0,5,96,0
2007-04-26 18:00:40,eHour-web/src/main/webapp/WEB-INF/jsp/pmReport/reportLayout.jsp,9,0,3,6,0
2007-04-26 18:00:40,eHour-web/src/main/webapp/WEB-INF/jsp/report/criteria/criteria.jsp,282,0,5,277,0
2007-04-26 18:00:40,eHour-web/src/main/webapp/WEB-INF/jsp/report/criteria/criteriaCustomerList.jsp,22,0,4,18,0
2007-04-26 18:00:40,eHour-web/src/main/webapp/WEB-INF/jsp/report/criteria/criteriaProjectList.jsp,21,0,4,17,0
2007-04-26 18:00:40,eHour-web/src/main/webapp/WEB-INF/jsp/report/criteria/criteriaUserList.jsp,22,0,4,18,0
2007-04-26 18:00:40,eHour-web/src/main/webapp/WEB-INF/jsp/report/report/reportPerCustomer.jsp,134,0,4,130,0
2007-04-26 18:00:40,eHour-web/src/main/webapp/WEB-INF/jsp/report/report/reportPerProject.jsp,118,0,4,114,0
2007-04-26 18:00:40,eHour-web/src/main/webapp/WEB-INF/jsp/report/report/reportPerUser.jsp,122,0,4,118,0
2007-04-26 18:00:40,eHour-web/src/main/webapp/WEB-INF/jsp/report/reportLayout.jsp,35,0,4,31,0
2007-04-26 18:00:40,eHour-web/src/main/webapp/WEB-INF/jsp/timesheet/overview.jsp,161,0,5,156,0
2007-04-26 18:00:40,eHour-web/src/main/webapp/WEB-INF/jsp/timesheet/overviewLayout.jsp,37,0,4,33,0
2007-04-26 18:00:40,eHour-web/src/main/webapp/WEB-INF/jsp/timesheet/printForm.jsp,85,0,4,81,0
2007-04-26 18:00:40,eHour-web/src/main/webapp/WEB-INF/jsp/timesheet/printLayout.jsp,19,0,3,16,0
2007-04-26 18:00:40,eHour-web/src/main/webapp/WEB-INF/jsp/timesheet/printSheet.jsp,132,0,4,128,0
2007-04-26 18:00:40,eHour-web/src/main/webapp/WEB-INF/jsp/timesheet/timesheet.jsp,186,0,3,183,0
2007-04-26 18:00:40,eHour-web/src/main/webapp/WEB-INF/jsp/userReport/criteria.jsp,104,0,5,99,0
2007-04-26 18:00:40,eHour-web/src/main/webapp/WEB-INF/jsp/userReport/projectReport.jsp,133,0,5,128,0
2007-04-26 18:00:40,eHour-web/src/main/webapp/WEB-INF/jsp/userReport/reportLayout.jsp,9,0,3,6,0
2007-04-26 18:00:40,eHour-web/src/main/webapp/accessDenied.jsp,41,0,3,38,0
2007-04-26 18:00:40,eHour-web/src/main/webapp/css/ehourAdmin.jsp,128,0,2,126,0
2007-04-26 18:00:40,eHour-web/src/main/webapp/css/ehourLogin.jsp,137,0,2,135,0
2007-04-26 18:00:40,eHour-web/src/main/webapp/css/ehourMain.jsp,457,0,2,455,0
2007-04-26 18:00:40,eHour-web/src/main/webapp/css/ehourReport.jsp,193,0,2,191,0
2007-04-26 18:00:40,eHour-web/src/main/webapp/css/ehourTimesheet.jsp,472,0,2,470,0
2007-04-26 18:00:40,eHour-web/src/main/webapp/css/ehourUserReport.jsp,75,0,2,73,0
2007-04-26 18:00:40,eHour-web/src/main/webapp/exceptions.jsp,12,0,0,12,0
2007-04-26 18:00:40,eHour-web/src/main/webapp/index.jsp,15,0,1,14,0
2007-04-26 18:00:40,eHour-web/src/main/webapp/js/admin/customerAdmin.jsp,60,0,1,59,0
2007-04-26 18:00:40,eHour-web/src/main/webapp/js/admin/departmentAdmin.jsp,60,0,1,59,0
2007-04-26 18:00:40,eHour-web/src/main/webapp/login.jsp,68,0,6,62,0
